#################
# ..   p         #
# oo    oo   ######
#     ..     #
#############