#################
# ..   p         #
# oo    oo   ######
#     .............    #
#############